000000100000000
000000100000000
000000000000000
000000000000001
111000000000001
000000000000001
000000000000000
000000111110000
000000111110000
000000000000000
011000000000000
010000000000000
000000000011000
000000000000000
000000110000000
000000100000000
000000100000000
000000000000000
000000000000000
000000000000000